WWWWWWWWWWWWWWWWWWWWWWWWWWWWWWWWWWWWWWWWWWW
W       W   W             W     W   W     W
WWWWWWW WWW W WWW WWWWWWW WWW W W W WWW WWW
W     W W   W   W   W   W     W   W   W   W
W W WWW W WWW WWWWW W WWWWWWWWWWWWWWW WWW W
W W W   W     W   W W         W     W     W
W W W WWW WWWWW W W WWWWW WWWWW WWW WWWWW W
W W W W   W   W W   W   W   W   W W     W W
W W W WWW WWW W WWWWW W W W W WWW WWWWW W W
W W W   W W   W       W W W W W   W   W W W
W WWWWW W W W WWWWWWWWW W W W W W W W W W W
W       W   W     W     W W W W W W W   W W
W WWWWWWWWWWWWWWW W WWWWWWW W W WWW WWWWW W
W   W             W     W   W   W   W   W W
WWW W WWWWWWWWWWWWWWWWW W WWWWW W WWW W W W
W W W W W           W   W   W   W W   W   W
W W W W W WWWWWWWWW W WWW W W WWW W WWWWWWW
W   W   W   W         W   W   W   W W     W
W WWWWWWW W W WWWWWWWWWWWWWWW W WWW WWW WWW
W W     W W W W   W         W W       W   W
W W WWW WWW WWW W W WWWWWWW WWWWWWWWW W W W
W   W   W   W   W W       W       W   W W W
WWWWW WWW WWW WWW W WWWWWWWWW WWW W WWWWW W
W   W W     W W W   W       W   W W W     W
W WWW W WWW W W WWWWW WWWWW WWWWW W WWW W W
W     W   W   W     W     W     W W W   W W
W WWWWWWW WWWWW WWW WWWWW WWWWW W W W WWW W
W   W   W W     W W W   W   W W   W W W W W
WWW W W W WWWWW W W W W WWW W WWWWW W W W W
W   W W       W W W   W W   W     W   W   W
W WWW WWWWWWW W W W WWWWW WWWWWWW WWWWW WWW
W   W W W   W   W   W     W       W   W W W
WWW W W W W WWWWWWW W WWWWW WWWWWWW W W W W
W   W   W W W     W W W       W     W   W W
W WWWWWWW W W WWW WWW WWWWWWW W WWWWWWWWW W
W       W W   W     W       W W W         W
WWWWWWW W WWWWWWWWW W WWWWW W W W WWWWWWW W
W     W W       W   W W W   W   W   W W   W
W W WWW WWWWWWW W WWW W W WWW WWW W W W WWW
W W     W   W   W   W   W   W W   W W   W W
W WWWWWWW W W WWWWW WWWWWWW W WWWWW W WWW W
W         W   W             W       W    EW
WWWWWWWWWWWWWWWWWWWWWWWWWWWWWWWWWWWWWWWWWWW
